1111111111111
1000E000000C1
1000000001001
1P00110000011
1111111111111
