1111111111111111111111
1P1111111C1111111111C1
1000000000000000C00001
1111111111111111111101
1000000C000000000C0001
1011111111111111111101
1000C000000000C0000001
1011111111111111111101
10000000C0000000000E01
1011111111111111111101
1000C00000000000C00001
1111111111111111111101
1C000000000000C0000001
1111111111111111111111
