11111111111111111111111
1P000C00000000000C00001
10111111111111111111101
101E0000C00000000000101
101011111111111110110C1
1010C0000000000001011C1
101111111111111101011C1
100000000C00001101011C1
111111111111101101011C1
1C0000000000101101011C1
101111111110101101011C1
101000000010101101011C1
101011111010101101011C1
1010C000010101101011001
10111110110101101011101
100000C0110101100000001
11111111110101111111111
1C000000000000000000C01
11111111111111111111111
