11111111111111111111111
1P1C000T100000010000E01
101111111011110111111C1
1010000000100001000T001
1011111110111111111T111
10100T0000100000000C001
101011111110111111111C1
10001000T010000010T0001
111110110111110110111C1
100000110000010110C0T01
101110111110010111111C1
1010T0000010010000000T1
101011111010011111111C1
1010C00T1010T10C0T00001
101111111010110111111C1
1T0000C01010110C000T001
11111111111111111111111
