1111111111111111111111
1P000000000000000000C1
1011111111111111111101
1010000000000000000101
1010111111111111110101
1010100000000000010101
1010101111111111010101
1010101000000001010101
1010101011111101010101
10101010100E0001010101
1010101010111111010101
1010101010000000010101
1010101011111111110101
1010101000000000000101
1010101111111111111101
10100000000000000000C1
1011111111111111111111
1000000000000000000001
1111111111111111111111
