1111111111111111111111111111111111
1E00000C0000000C00000C000000C000C1
1010010100100000101001000C00010101
101001001010101000100100C000010101
1P00C0000C00C00000000C0000C00000C1
1111111111111111111111111111111111
