11111111111111111111
1P010101C101C10101C1
1000C00000000000C001
10111111111111111111
10000C000000000C0001
10111111111111111101
1000C000000000C00001
10111111111111111101
100C000000C000000001
10111111111111111101
1000000C0000000C0001
10111111111111111101
1000C0000000000C0001
10111111111111111101
10000C0000000C000001
1C00000000C0000000E1
11111111111111111111
