11111111111111111
1P000000000000001
10111011101110101
1C000C000C000C001
10111011101110101
1C000C000C000C001
10111011101110101
1C000C000C000C001
10111011101110101
1000000000000E001
11111111111111111
